0000000000000000000000000000
0000000000000000000000000000
0000000000000000000000000000
1222222222222312222222222223
4000000000000440000000000004
4012230122230440122230122304
4040040400040440400040400404
4052260522260560522260522604
4000000000000000000000000004
4012230130122222230130122304
4052260440522312260440522604
4000000440000440000440000004
5222230452230440122640122226
0000040412260560522340400000
0000040440000000000440400000
0000040440122222230440400000
2222260560400000040560522222
0000000000400000040000000000
2222230130400000040130122222
0000040440522222260440400000
0000040440000000000440400000
0000040440122222230440400000
1222260560522312260560522223
4000000000000440000000000004
4012230122230440122230122304
4052340522260560522260412604
4000440000000000000000440004
5230440130122222230130440126
1260560440522312260440560523
4000000440000440000440000004
4012222652230440122652222304
4052222222260560522222222604
4000000000000000000000000004
5222222222222222222222222226
0000000000000000000000000000
0000000000000000000000000000