1222222222222312222222222223
4888888888888448888888888884
4812238122238448122238122384
4947748477748448477748477494
4852268522268568522268522684
4888888888888888888888888884
4812238138122222238138122384
4852268448522312268448522684
4888888448888448888448888884
5222238452237447122648122226
7777748412267567522348477777
7777748447777777777448477777
7777748447122222237448477777
2222268567477777747568522222
7777778777477777747778777777
2222238137477777747138122222
7777748447522222267448477777
7777748447777777777448477777
7777748447122222237448477777
1222268567522312267568522223
4888888888888448888888888884
4812238122238448122238122384
4852348522268568522268412684
4988448888888778888888448894
5238448138122222238138448126
1268568448522312268448568523
4888888448888448888448888884
4812222652238448122652222384
4852222222268568522222222684
4888888888888888888888888884
5222222222222222222222222226